30 30
85 138 113 115 113 113 115 116 36 113 113 116 116 114 114 116 114 115 115 115 116 116 113 116 113 115 116 114 116 113 
4 42 33 19 42 19 44 53 16 48 30 33 58 43 116 116 42 105 76 93 83 98 110 113 113 113 113 113 115 115 
40 50 12 12 26 20 50 11 43 19 19 25 9 43 50 28 9 104 90 92 95 107 95 80 100 109 86 87 22 115 
28 1 3 10 52 25 50 26 59 51 41 9 10 36 33 59 27 88 78 91 82 83 79 109 82 75 108 77 44 115 
39 36 57 50 153 35 25 2 36 50 34 4 26 11 33 42 110 84 99 89 95 105 109 88 76 80 83 75 5 114 
47 10 51 51 138 114 115 113 20 146 116 27 1 11 89 104 103 84 110 96 86 90 97 80 77 111 84 103 88 114 
31 28 20 26 25 116 115 114 114 24 56 24 39 54 45 4 109 100 89 99 94 93 78 77 95 100 94 101 73 115 
28 18 4 60 19 3 28 42 116 39 38 11 23 23 20 1 44 15 75 99 83 73 87 105 81 87 87 79 96 116 
15 59 10 28 148 44 43 35 115 13 55 23 39 38 49 27 27 52 79 82 34 107 108 88 88 75 76 78 77 116 
40 3 3 1 52 122 124 15 15 46 45 13 8 30 50 35 45 1 2 98 19 98 90 84 90 87 78 77 103 100 
38 36 33 130 138 121 155 39 5 37 6 43 11 35 11 27 49 51 34 17 7 17 101 85 83 100 107 96 94 98 
21 51 17 51 28 9 2 46 41 27 44 9 51 26 44 10 56 9 4 30 16 54 98 92 107 97 94 100 89 90 
20 41 57 25 19 12 42 115 114 20 42 3 20 11 18 10 35 17 48 39 42 17 100 107 94 85 104 112 103 107 
50 44 9 49 140 153 10 116 9 19 18 49 11 50 17 2 50 49 5 32 20 51 90 102 2 9 91 90 100 111 
21 34 42 130 138 18 52 26 12 20 44 20 44 10 20 116 116 30 53 19 43 52 91 101 11 2 4 107 89 102 
53 17 59 10 59 34 26 44 42 17 51 43 27 36 114 116 113 116 113 40 37 18 97 109 93 33 49 113 113 108 
51 41 11 58 139 60 11 26 44 28 36 49 4 28 23 116 40 114 115 113 114 116 19 41 50 106 113 111 113 113 
15 59 2 27 12 163 116 20 2 19 54 17 52 42 39 113 115 53 44 2 8 113 114 34 49 17 103 99 113 113 
47 4 12 131 147 19 114 43 19 52 25 2 40 32 7 5 116 113 49 23 39 21 18 49 4 3 97 111 113 113 
40 4 19 116 10 42 146 28 35 12 11 25 35 52 4 36 115 114 113 53 27 116 4 35 40 26 35 28 113 113 
32 17 41 113 41 124 147 50 122 130 154 42 10 147 10 19 7 54 53 11 27 20 114 41 22 41 18 41 113 115 
55 19 4 164 123 140 42 19 122 49 154 43 43 28 155 11 28 164 33 27 50 2 28 10 19 50 3 113 113 113 
56 32 33 2 9 2 49 11 17 124 43 145 19 28 20 25 50 33 49 17 51 115 33 12 34 51 17 154 122 139 
56 23 45 36 27 10 19 36 44 43 9 11 155 148 162 146 145 162 155 51 49 51 9 26 123 137 116 154 140 145 
45 15 45 45 5 29 35 26 28 146 164 162 148 12 49 139 132 145 147 153 35 56 52 148 129 164 140 139 114 122 
30 21 37 37 32 38 54 6 49 164 146 132 140 18 36 123 4 140 121 139 28 13 48 7 130 164 153 115 124 146 
22 37 31 6 16 37 44 14 28 46 2 155 154 3 11 154 34 27 44 9 17 44 9 147 148 131 115 164 113 155 
31 54 24 40 31 37 22 33 17 28 37 29 28 51 33 139 162 48 162 139 49 52 164 139 163 140 113 129 132 137 
54 55 32 21 21 31 13 40 53 28 21 16 46 51 26 7 28 38 34 146 25 17 155 113 115 139 140 137 146 129 
14 30 5 7 48 33 14 24 21 23 48 5 23 37 55 6 38 14 28 50 28 36 132 161 145 113 131 113 114 161
