30 30
121 132 33 12 43 43 43 116 149 144 157 159 165 127 144 168 138 129 139 115 137 138 115 142 137 138 124 131 122 132 
41 132 122 9 43 33 2 124 121 125 127 125 125 120 144 18 139 113 123 130 131 116 135 121 130 116 138 137 129 123 
33 4 137 121 36 26 132 123 130 134 133 128 152 136 133 157 1 129 131 131 122 114 136 139 130 124 129 137 137 116 
44 4 52 130 123 1 114 132 123 49 128 149 133 149 158 149 34 137 3 136 157 152 159 144 141 128 130 129 122 138 
1 34 17 139 25 25 51 1 129 151 157 150 167 119 126 27 137 130 28 27 151 158 127 151 158 27 11 9 113 115 
50 17 131 137 19 9 11 138 124 168 151 28 141 117 135 2 116 3 1 20 143 127 165 157 1 28 34 43 27 52 
9 19 115 131 10 20 132 113 34 166 144 149 135 158 17 9 139 52 28 17 120 167 141 28 130 131 132 140 25 4 
10 129 132 10 12 132 132 18 43 11 10 19 43 26 3 113 116 9 44 19 9 1 136 158 50 17 44 113 124 27 
27 113 44 124 115 116 50 25 41 25 159 28 34 17 35 124 114 34 42 27 44 115 49 11 33 35 3 12 121 121 
115 132 52 12 140 115 114 140 124 123 168 17 50 41 130 137 116 35 3 10 12 44 139 52 42 1 2 10 44 116 
114 52 35 42 18 123 137 124 124 150 135 42 124 121 123 43 52 1 27 26 43 33 130 35 9 26 11 41 137 2 
139 35 49 11 137 124 26 166 128 143 168 34 114 4 2 26 43 1 9 26 18 10 50 1 25 9 19 9 131 138 
131 1 131 124 115 129 11 150 157 134 165 113 139 34 19 35 27 2 130 129 9 33 1 33 2 50 41 140 123 49 
35 124 130 33 126 126 119 136 160 10 44 121 33 35 17 2 1 113 129 3 50 132 11 10 114 116 113 131 9 42 
115 131 12 118 152 128 117 168 118 50 124 138 26 12 20 121 131 123 4 34 34 132 17 33 130 42 44 4 44 19 
130 118 120 144 168 133 151 168 52 131 124 3 26 152 11 2 116 129 36 9 1 3 10 9 113 2 36 19 27 11 
116 119 126 134 34 167 151 52 130 132 36 128 127 126 122 138 4 113 140 28 50 10 19 11 113 44 28 19 36 27 
140 141 133 120 118 167 25 122 115 159 166 127 134 41 42 132 34 51 113 124 139 33 124 131 113 123 140 123 52 9 
141 157 150 128 128 41 121 140 125 165 135 143 160 3 118 130 137 4 18 20 129 36 130 121 130 115 129 138 115 11 
160 166 150 151 27 138 122 125 136 150 125 151 117 126 128 123 123 20 51 12 43 113 124 138 139 123 116 116 114 9 
125 165 141 152 129 2 10 10 117 128 135 144 120 168 33 139 122 41 33 26 25 121 138 139 138 25 34 17 113 10 
141 143 120 36 123 1 50 10 136 157 128 159 166 120 157 19 131 41 12 10 9 132 116 132 36 36 44 10 52 9 
144 142 119 138 114 33 167 166 117 143 157 125 125 134 168 18 140 35 11 9 35 114 114 139 2 19 129 137 1 42 
167 149 34 137 17 42 10 143 144 167 120 159 9 50 26 42 116 9 34 1 34 124 123 132 35 20 123 138 138 17 
120 126 17 138 19 18 52 3 1 36 136 25 34 11 123 115 129 124 113 139 18 52 3 137 20 34 130 129 116 10 
165 2 42 116 52 4 123 140 33 2 42 25 50 28 4 35 52 138 132 124 27 11 41 115 123 3 115 138 115 4 
141 17 115 140 4 12 9 132 122 130 114 114 137 9 51 43 20 43 138 123 9 2 41 9 132 41 42 35 132 12 
128 116 129 17 28 12 139 4 19 132 137 140 138 42 33 41 3 19 114 121 131 3 26 51 10 11 43 27 17 19 
165 158 12 123 51 115 130 44 34 137 28 130 122 9 43 20 129 3 44 1 27 50 19 3 114 114 116 116 114 51 
125 133 52 43 17 26 52 49 33 137 129 137 130 123 113 34 18 10 28 11 1 44 17 41 34 34 41 2 115 124
