30 30
139 139 49 122 130 140 129 140 145 156 33 155 154 26 51 116 138 25 19 36 10 162 121 49 52 52 116 122 42 18 
139 139 139 50 113 132 154 123 155 146 139 132 156 33 33 33 161 4 17 146 114 162 131 138 131 131 122 163 132 42 
33 139 139 139 33 33 130 138 121 161 114 132 156 33 21 18 146 139 27 154 161 147 121 156 147 131 154 163 129 11 
50 123 139 132 139 33 153 124 154 113 40 14 7 8 31 37 45 148 115 164 140 145 155 131 138 137 156 116 161 131 
113 154 131 156 139 33 33 124 21 130 6 45 56 56 56 45 54 116 148 132 116 140 25 154 156 161 122 153 138 36 
153 140 153 139 139 139 33 129 33 162 140 33 15 53 33 15 45 44 122 153 145 10 3 17 137 129 156 162 137 121 
140 123 113 162 139 139 139 115 163 155 132 16 8 33 33 30 47 161 153 161 113 154 145 139 155 50 146 131 161 146 
33 153 122 137 162 156 139 139 33 14 86 30 33 33 33 33 9 113 146 132 1 114 148 140 28 49 154 161 148 162 
33 114 114 145 145 155 139 139 139 19 30 47 14 30 16 19 33 122 155 137 20 139 131 129 11 42 146 156 10 121 
161 147 130 33 146 146 147 139 139 139 47 47 6 45 87 14 150 167 165 164 155 42 139 129 139 139 155 116 140 131 
115 153 154 132 113 114 122 163 139 139 33 134 143 10 54 62 160 149 133 12 2 33 122 131 139 139 17 123 123 130 
164 148 137 147 156 163 145 162 140 121 139 152 159 166 158 134 149 118 167 134 28 12 36 147 137 156 51 12 147 139 
139 156 139 147 164 33 164 116 116 124 139 139 160 168 165 152 126 128 149 151 19 3 10 153 153 132 52 34 122 121 
139 33 153 33 164 132 145 137 156 121 139 139 139 152 141 158 141 157 150 117 4 3 43 139 139 9 9 1 18 129 
139 33 52 33 115 124 148 113 33 129 139 139 139 135 167 168 168 120 126 152 130 139 139 11 33 1 44 139 42 17 
139 33 25 49 44 33 146 115 33 9 166 139 139 139 151 160 125 136 119 143 145 115 123 148 3 2 139 139 19 25 
139 2 34 34 35 28 1 33 3 142 165 158 139 139 139 149 167 159 117 148 161 140 124 122 116 43 139 139 139 49 
139 42 19 43 18 28 42 35 25 119 149 128 158 139 139 92 89 159 132 131 138 138 138 124 162 3 139 139 139 17 
139 41 41 12 28 50 2 26 19 125 168 168 133 143 10 42 89 127 138 139 113 139 116 43 123 137 9 139 139 139 
139 52 44 33 25 20 117 127 125 143 136 143 143 50 17 36 12 139 115 140 25 34 50 162 163 139 139 139 139 139 
139 35 33 4 4 141 133 128 143 167 160 165 150 151 157 18 139 139 139 122 139 20 129 139 139 130 156 139 139 49 
139 33 10 17 19 133 160 150 136 150 118 166 118 144 142 133 44 49 139 9 153 156 124 129 138 137 139 122 156 139 
139 43 34 2 149 149 144 128 141 128 136 119 158 119 158 136 26 12 139 27 114 130 145 131 146 124 129 163 139 115 
139 139 135 144 136 142 152 126 127 125 26 35 43 127 158 157 36 9 139 50 26 33 33 33 33 155 147 148 154 129 
139 139 126 149 142 134 149 157 128 35 19 51 27 151 10 34 51 33 33 51 33 33 33 33 33 33 33 139 139 139 
139 139 35 159 158 141 160 152 25 43 17 33 2 17 119 151 50 33 33 43 33 4 11 33 140 129 33 33 33 33 
139 139 52 4 127 26 25 17 3 52 41 1 28 18 3 118 118 33 33 33 27 3 7 14 139 121 122 138 33 44 
3 33 44 10 33 33 33 33 35 17 33 33 33 33 33 12 33 33 33 33 42 9 47 139 139 139 162 129 130 49 
52 4 51 51 139 139 139 139 33 33 33 33 33 33 33 33 33 33 33 52 44 28 21 139 139 139 139 139 139 139 
27 28 25 139 139 139 139 139 139 139 139 139 139 139 139 139 139 51 41 43 19 3 21 31 139 139 139 139 139 139